11111111111111111111111111111111
1111111111110C1111C0001111111111
11111111111000111000000011111111
11111111110000111C11110001111111
11111111110000111111111001111111
11111111100100111111111100111111
11111111001100111111111100111111
11111110001100111111111100111111
11111110011100111111111001111111
11111100000000001111110001111111
11111100000000001111100011111111
11111111111001111110001111111111
11111111111001111100011111111111
11111111111001111000111111111111
11111111111P00000000000CE1111111
11111111111111111111111111111111