1111111
1000001
100P001
1000001
1111111
0000000
0000000