111111111111
1P01000C1C01
110101111101
100001000001
101111011101
101000010001
100001111101
101101000101
100101C10001
111111111111