1111111
1C1E1C1
100P001
1C1C1C1
1111111