1111111111111111
1P1C100000000001
100000000C000001
111100000V000001
100000000C000001
1000CHC000000001
1000000000000001
1000000000000001
10000000000CC0E1
1111111111111111