
1111111
10C0001

1CPC1E1

10C0001
1111111
