111111111
10C00H001
1CPC10E01
10C00V001
111111111