1111111
1000001
10PCE01
1000001
1111111