111111111
10CH00001
1CPC10E01
1VC00V001
111111111