111111
1E00C1
111011
1P00C1
111111