111111111
10CH000H1
1CPC10E01
10C00V001
111111111