111111111
10C01C0C1
1CPC1VE01
10C0000H1
111111111