1111111
10C0001
1CPCEC1
10C0001
1111111