1111111
10C0001
1C0CEC1
10P0001
1111111