1111111
1P1C1E1
1010101
10V0H01
1000001
1111111