1111111
1P1E1C1
10100C1
10V00H1
1111111