1111111111111111111111111111
1000000001000000000000000001
100000C001000000000000000001
100000P001000000000000000001
100000E001000000000000000001
1000000001000000000000000001
1111111111000000000000000001
1000000001000000000000000001
1000000001000000000000000001
1111111111111111111111111111